4444000000000000000000000000000000000000
4444000000000000000000000000000000000000
4441111111100333333300222222222222200000
4444000000100444444400222222222222200000
0000000000100333333300333333333333300000
0000000000100000000000222222222222200000
0000000000111111111110222222222222200000
2000000000000000000010000000000000000000
2000333000000000111110000000000000000000
2000343000000000100000000000000000000000
2000333000000000111111111111111110000000
2000000000000000000000000000000010000000
2011111111110000000000000000000010000000
0010000000011111111111111111111110000000
0010000000000000000000000000000000000000
0011111111111111111111111100222222200000
0000000000000000000000000100222222200000
0002220000000000000000000100222222200000
0003330011111111111111111100222222200000
0002220010000000000000000000000000004444
0000000010022222222222222222222000004444
0000000010000000000000000000000000004444
0000000011111111111111111111111111111444
0000000000000000000000000000000000004444
0000000000000000000000000000000000000000
